000000000000000000000000000000000000000000000000000000000
000000000000000000000000000000000000000000000000000000000
000000000011111111111111111111111111111111110000000000000
000000000000000000000000000000000000000000000000000000000
000000000000000000000000000000000000000000000000000000000
000000000000000000000000000000000000000000000000000000000
000001111111000000000000000000000000000000000000000000000
000000000002000000000000000000000000000000000000000000000
011111111102111111110111111333333331000000000000001000000
000000000200000000000200002333333332000000000000000000100
000000000222222222222200002333333332000000000001111000000
000000000000000000000000002222222222111111100012200000000
000000000000000000000000000000000000000000000000000000000